X...............X................X..............X.
..................................................
..................................................
....BBBBBBBB..........BBBBBBBB..........BBBBBBBB..
....BBBBBBBB..........BBBBBBBB..........BBBBBBBB..
....BBBBBBBB..........BBBBBBBB..........BBBBBBBB..
..................................................
....BBBB....WWW....SSSSS..SSSSS..G......BBBBB.....
....B..B...W...W.....S......S....G......B.........
....BBB... WWWWW.....S......S....G......BBBBB.....
....B..B..W.....W....S......S....G......B.........
....BBBB..W.....W....S......S....GGGGG..BBBBB.....
..................................................
..........SGGBW..B..SGSGS..G...G..................
..........S......S....G....S...S..................
..........W......G....S....WGSGW..................
..........S......W....G......S....................
..........SGGBW..B....S......G....................
..................................................
..................................................
........WWWWWWWWWW..WWWWWWWWWW..WWWWWWWWWW........
...GGGGGWWWWWWWWWWGGWWWWWWWWWWGGWWWWWWWWWWGGGGG...
...GGGGGWWWWWWWWWWGGWWWWWWWWWWGGWWWWWWWWWWGGGGG...
........WWWWWWWWWW..WWWWWWWWWW..WWWWWWWWWW........
...........GGGG........GGGG........GGGG...........
...........GGGG........GGGG........GGGG...........
...........GGGG........GGGG........GGGG...........
...........GGGG........GGGG........GGGG...........
..................................................
..................................................
..................................................
GG..............................................GG
GGGG......PP..................................GGGG
GGGG......PP............EE....................GGGG
SSGGG...................EE...................GGGSS
SSGGG........................................GGGSS
