X..........X............X...........X...........X.
..................................................
..................................................
..SSSS..........SSSS..........SSSS..........SSSS..
..SSSS..........SSSS..........SSSS..........SSSS..
..SSSS..........SSSS..........SSSS..........SSSS..
......WWWWWWWWWW..................WWWWWWWWWW......
......WWWWWWWWWW..................WWWWWWWWWW......
......WWWWWWWWWW..................WWWWWWWWWW......
......WWWWWWWWWW..................WWWWWWWWWW......
..BBBB..........BBBB..........BBBB..........BBBB..
..BBBB..........BBBB..........BBBB..........BBBB..
..BBBB..........BBBB..........BBBB..........BBBB..
..BBBB..........BBBB..........BBBB..........BBBB..
WWWWWWWWWW..........WWWWWWWWWW..........WWWWWWWWWW
..WWWWWWWWWW........WWWWWWWWWW........WWWWWWWWWW..
....WWWWWWWWWW......WWWWWWWWWW......WWWWWWWWWW....
......WWWWWWWWWW....WWWWWWWWWW....WWWWWWWWWW......
..GGGG..........GGGG..........GGGG..........GGGG..
..GGGG..........GGGG..........GGGG..........GGGG..
..GGGG..........GGGG..........GGGG..........GGGG..
..GGGG..........GGGG..........GGGG..........GGGG..
......WWWWWWWWWW..................WWWWWWWWWW......
....WWWWWWWWWW......................WWWWWWWWWW....
..WWWWWWWWWW..........................WWWWWWWWWW..
WWWWWWWWWW..............................WWWWWWWWWW
..................................................
..................................................
..................................................
..................................................
..................................................
GG..............................................GG
GGGG......PP..................................GGGG
GGGG......PP............EE....................GGGG
SSGGG...................EE...................GGGSS
SSGGG........................................GGGSS
