X.......................X.......................X.
..................................................
..................................................
...BBBB.........WWWW..........WWWW.........BBBB...
...BBBB.........WWWW..........WWWW.........BBBB...
...BBBB.........WWWW..........WWWW.........BBBB...
..................................................
..................................................
SSSSSSSSSSSSSBBBBBBBBBBSSSSBBBBBBBBBBSSSSSSSSSSSSS
.........GGGG..........GGGG..........GGGG.........
.........GGGG..........GGGG..........GGGG.........
.........SSSSBBBBBBBBBBSSSSBBBBBBBBBBSSSS.........
..................................................
..................................................
GGGGGGGGGGGGSSSSSSSSSSSSSSSSSSSSSSSSSSGGGGGGGGGGGG
GGGGGGGGGGGGSSSSSSSSSSSSSSSSSSSSSSSSSSGGGGGGGGGGGG
GGGGGGGGGGGGSSSSSSSSSSSSSSSSSSSSSSSSSSGGGGGGGGGGGG
GGGGGGGGGGGGSSSSSSSSSSSSSSSSSSSSSSSSSSGGGGGGGGGGGG
..................................................
..................................................
BBBBBBBBBBBBBBBBBBBBBBBBBBBBBBBBBBBBBBBBBBBBBBBBBB
BBBBBBBBBBBBBBBBBBBBBBBBBBBBBBBBBBBBBBBBBBBBBBBBBB
..................................................
..................................................
..................................................
..................................................
..BBBB..........WWWW..........GGGG..........SSSS..
..BBBB..........WWWW..........GGGG..........SSSS..
..BBBB..........WWWW..........GGGG..........SSSS..
..BBBB..........WWWW..........GGGG..........SSSS..
..................................................
GG..............................................GG
GGGG......PP..................................GGGG
GGGG......PP............EE....................GGGG
SSGGG...................EE...................GGGSS
SSGGG........................................GGGSS
